5,29
#############################
#       1    2    3   4     #
# ######################### #
#              P            #
#############################
