20,29
#############################
#                           #
# ######################### #
#                           #
#                           #
#                           #
#                           #
#                           #
#                           #
#                           #
#                           #
#                           #
#                           #
#                           #
#                           #
#                           #
#                           #
#                           #
#                           #
#############################
